######
#S...#
####.#
##...#
#..#.#
#G.###
######
